NO ./textures/amandine.xpm
SO ./textures/mac64.xpm
WE ./textures/shrek64.xpm
E ./textures/jj.xpm
F 0,255,0
C 112,0,255

        1111111111111111111111111
        1000000000110000000000000
        1011000001110000000000001
        1001000000000000000000001
111111111011000001110000000000001
100000000011000001110111111111111
11110111111111011100000010001
11110111111111011101010010001
110000000011100000000000010001
10000000000000000   0000000000001
100000000000000000010110000011
11000001110101011111011110E011
11110111 1110101 0011110000011
11111111 11111111 1111111111111