NO ./texture1.lol
SO ./texture1.lol
WE ./texture1.lol
EA ./texture1.lol
F 220,100,0
C 225,30,0

        1111111111111111111111111
        1000000000110000000000001
        1011000001110000000000001
        1001000000000000000000001
111111111011000001110000000000001
100000000011000001110111111111111
11110111111111011100000010001
11110111111111011101010010001
110000000011100000000000010001
10000000000000000   000000010001
10000000000000000001010010001
11000001110101011111011110N001
11110111 1110101 101111010001
11111111 11111111 1111111111111